33333333333333333333333333
3                        3
3                        3
3  33333333333333333333  3
3  3                  3  3
3  3                  3  3
3  3  33333333333333  3  3
3  3  3            3  3  3
3  3  3            3  3  3
3  3  3  33333333  3  3  3
3  3  3  3      3  3  3  3
3  3  3  3      3  3  3  3
3  3  3  3  33  3  3  3  3
3  3  3  33333  3  3  3  3
3  3  3         3  3  3  3
3  3  3         3  3  3  3
3  3  33333333333  3  3  3
3  3               3  3  3
3  3               3  3  3
3  3    3333333333 3  3  3
3  3    3        3 3  3  3
3  3    3        3 3  3  3
3  333333  1111  333  3  3
3          1  1       3  3
3          1  1       3  3
33333333333333333333333333
